product_name,category,transaction_count,sales_count,refund_count,customer_count
Kelímek - záloha,,29148,17933,11215,8729
Radegast 12°,Pivo,12870,12844,26,3760
Hladinka - Prazdroj,Pivo,9127,9106,21,2958
Radegast 10°,Pivo,7674,7662,12,2846
"Frisco 0,4l",Pivo,6647,6643,4,2214
Birell,Nealko,4373,4367,6,2321
"Absolut vodka 0,04l",Ostatní alkohol,3351,3348,3,1262
"ZON 0,5l",Nealko,2992,2983,9,1681
Redbull - klasik,Nealko,2798,2787,11,1334
"Proud 0,4l",Pivo,2452,2448,4,1209
Langoš,Slané,1982,1982,0,1760
Becherovka Lemond,Ostatní alkohol,1925,1922,3,974
Beefeater + Dry Tonic,Ostatní alkohol,1848,1848,0,926
Pizza 1 kus,Slané,1633,1631,2,1180
"Voda 0,5l",Nealko,1553,1547,6,1068
"Cola 0,5l",Nealko,1305,1300,5,889
Absolut Vodka + redbull,Ostatní alkohol,1281,1276,5,769
VIP - Prazdroj,Pivo,1274,1273,1,237
Příloha,Slané,1216,1215,1,1013
Havana Cuba Libre,Ostatní alkohol,1208,1206,2,534
"Beefeater Pink, Orange, Peach + Tonic",Ostatní alkohol,1102,1101,1,661
Domácí Hranolky velké,,950,950,0,835
Bramborák,Slané,875,875,0,714
Domácí hranolky malé,,868,868,0,772
Nudle s gyrosem,Slané,824,824,0,733
Klobása,Slané,775,774,1,694
TRDELNÍK,,677,677,0,614
"ZON 0,3l",Nealko,626,623,3,452
Malibu + Pineapple,Ostatní alkohol,622,621,1,312
Fire Štrúdl,Ostatní alkohol,576,576,0,291
Pizza 2 kusy,Slané,513,512,1,467
Tortila s gyrosem,Slané,511,511,0,463
"VInný střik 0,5 l",Víno,504,504,0,197
Churros s omáčkou,,499,499,0,451
Ořez prasate,Slané,496,496,0,427
Durum,Slané,478,478,0,428
BEERPONG - PIVO,Pivo,439,439,0,272
Smažení nudle s kuř. Masem,Slané,436,436,0,394
BEERPONG - STARTOVNÉ,Doplňkový sortiment,429,429,0,270
Absolut Skinny Bitch,Ostatní alkohol,391,391,0,175
Cappuccino,Nealko,384,384,0,294
"Prosecco 0,1l",Víno,374,374,0,231
KELÍMEK ZÁLOHA,Doplňkový sortiment,359,358,1,264
Jarní zážitek,Slané,356,356,0,302
Absolut + Džus,Ostatní alkohol,338,338,0,194
Espresso,Nealko,335,335,0,258
"Aperol, Hugo spritz",Ostatní alkohol,315,314,1,181
Jack Daniel's + Cola,Ostatní alkohol,309,309,0,211
Smažení nudle s gyrosě,Slané,307,307,0,283
Smažení nudle se zeleninou,Slané,305,305,0,272
Chléb,Slané,301,301,0,267
Ciao Spritz,,300,299,1,181
Jack Daniel's Apple + Tonic,Ostatní alkohol,294,294,0,234
Box,,289,289,0,266
Zmrzlina,Sladké,285,285,0,239
Redbull - Tropic,Nealko,285,285,0,179
"VIP - ZON (cimo) 0,5l",Nealko,274,274,0,120
Burger malý 100g,Slané,269,269,0,237
IPA,Pivo,268,267,1,125
"Láhvové víno 0,1 l",Víno,264,264,0,107
Franz Spalek,Pivo,253,253,0,156
"Víno 0,1l",Víno,244,243,1,98
Hermelín,Slané,242,242,0,218
Redbull - Summer,Nealko,236,236,0,160
"Jack Daniel's Honey 0,04l",Ostatní alkohol,235,235,0,163
Waffle TOP,Sladké,232,231,1,221
Oštěpok,Slané,231,231,0,195
Malibu,Ostatní alkohol,226,226,0,142
"Stáčené víno 0,3 l",Víno,223,223,0,105
Gril. Maso,Slané,209,208,0,175
"VIP - Voda 0,5l",Nealko,206,206,0,111
"VIP - Cola 0,5l",Nealko,201,201,0,112
Marakuja Spritz,,199,199,0,126
"VIP - ZON (cimo) 0,3l",Nealko,193,193,0,97
"Vinný střik 0,3 l",Víno,191,190,1,97
Jack Daniel's + Zázvor,Ostatní alkohol,189,188,1,138
Radegast 10,Pivo,188,0,0,9
"VIP - Víno 0,1l",Víno,185,185,0,64
Magnetka,Doplňkový sortiment,184,184,0,181
"Beefeater Pink 0,04l",Ostatní alkohol,176,176,0,117
Ostatní - Jihlava,,174,174,0,97
"Stáčené víno 0,1 l",Víno,173,173,0,75
"Havana 3 Y.O. 0,04l",Ostatní alkohol,168,168,0,98
sobota,,168,168,0,0
Zelenina,Slané,167,167,0,155
Hranolky s gyrosem,Slané,166,166,0,150
Zmrlina,Sladké,155,155,0,141
Waffle standard,Sladké,154,154,0,144
Sýr burger,Slané,153,153,0,141
Bacon,,149,149,0,136
VIP - Beefeater Gin Tonic,Ostatní alkohol,147,147,0,62
Tortilla s kuřecím,Slané,143,143,0,139
Malfy Rosa + Tonic,Ostatní alkohol,142,141,1,83
"VIP - Stáčená soda 0,1l",Nealko,138,138,0,60
Domácí Limonada,,136,136,0,93
Belgické hranolky,Slané,135,135,0,118
Lungo,Nealko,134,134,0,113
"Jack Daniel's Apple 0,04l",Ostatní alkohol,133,133,0,109
Hugo Spritz,,129,129,0,80
Ledové karamelové latté,Nealko,127,127,0,111
čtvrtek,,127,127,0,0
Cheese,,126,126,0,114
Berger velký 200g,Slané,126,126,0,113
"Jack Daniel's Fire 0,04l",Ostatní alkohol,123,122,1,80
Salsa limonáda,Nealko,123,123,0,78
pátek,,122,121,1,0
Gyros Box VELKÝ,Slané,120,120,0,114
"Beefeater Dry 0,04l",Ostatní alkohol,117,115,2,88
"Sodová voda 0,5l",Nealko,114,113,1,90
Gyros Box MALÝ,Slané,113,113,0,108
"Aperol Spritz 0,18l",Víno,113,113,0,89
Redbull - Red,Nealko,111,111,0,75
Šnyt - Prazdroj,Pivo,110,109,1,48
"Jameson 0,04l",Ostatní alkohol,108,108,0,59
Tortilla s trhaným,Slané,106,106,0,99
Smažák v žemli,Slané,105,105,0,97
"Jack on the rocks 0,04l",Ostatní alkohol,102,102,0,79
Jack Daniel's Honey + Lemonade,Ostatní alkohol,102,102,0,79
VIP - Káva s mlékem/bez mléka,Nealko,102,102,0,57
Trhané v žemli,Slané,100,100,0,97
"Bumbu original 0,04l",Ostatní alkohol,99,99,0,74
Pláštěnka,Doplňkový sortiment,99,99,0,97
Jameson + Ginger,Ostatní alkohol,98,98,0,67
Ledový čaj,Nealko,97,97,0,80
Latté,Nealko,92,92,0,77
TRHANÝ DOG,Slané,92,92,0,92
VIP - Cuba Libre,Ostatní alkohol,90,90,0,38
"Sodová voda 0,3l",Nealko,90,90,0,44
Popcorn malý,Slané,87,87,0,79
Popcorn střední,Slané,86,86,0,79
Přílohové hranolky,Slané,85,85,0,80
VIP - Jack Daniel's dle nabídky,Ostatní alkohol,83,83,0,39
Ostatní Jihlava 32Kč/km,,79,79,0,36
Pizza 4 kusy,Slané,79,78,1,74
Powerbanka,,78,39,39,34
Nabíječka,Doplňkový sortiment,78,39,39,36
"Soda 0,1l",Nealko,76,76,0,47
"Coca cola 0,1l",Nealko,76,76,0,55
Pláštěnka obyčejná,Doplňkový sortiment,73,73,0,67
"Lemond Apple 0,2l",Ostatní alkohol,72,72,0,42
"Hugo Spritz 0,2l",Víno,70,70,0,48
Bramborák se zelím,Slané,69,69,0,66
Kuřecí stehno,Slané,68,68,0,64
Popcorn velký,Slané,66,66,0,63
Frappe,Nealko,65,65,0,61
Lynchburg Lemonade,Ostatní alkohol,64,64,0,50
Frapé,Nealko,62,62,0,59
VIP - Skinny Bitch,Ostatní alkohol,62,62,0,26
Flat white,Nealko,61,61,0,55
Hot dog s cibulkou,Slané,59,59,0,59
VIP - Jägermeister,Ostatní alkohol,59,59,0,22
Pizza 3 kusy,Slané,58,58,0,55
Doppio,Nealko,57,57,0,46
Doplatek soda,,55,55,0,31
Radler (Radek 10° + ZON),Pivo,55,50,5,28
VIP - Absolut vodka,Ostatní alkohol,51,51,0,26
Oxbar C800,Doplňkový sortiment,50,50,0,46
"Spritz 0,1l",Víno,50,50,0,27
Fotka,,49,49,0,42
KISELÁČ,Pivo,49,49,0,24
Shisha light,,47,47,0,37
"Beefeater Blood Orange 0,04l",Ostatní alkohol,47,47,0,32
Gulášová polévka,Slané,46,46,0,39
Jihlava - Centrum,,44,44,0,23
ASIA DOG,Slané,43,43,0,43
"Beefeater Peach 0,04l",Ostatní alkohol,43,43,0,34
"Frizzante 0,1l",Víno,42,42,0,31
Hallomi,,42,42,0,41
Espresso / lungo,Nealko,41,41,0,38
Tatarka,Slané,40,40,0,40
děti,,40,40,0,0
Silikonový blikací náramek,Doplňkový sortiment,39,39,0,38
3 dny,,38,38,0,0
Hot dog CHEESE,Slané,37,37,0,37
Hranolky / Crispers,Slané,37,37,0,35
"VIP - Prosecco 0,1l",Víno,37,37,0,19
FRESH PORK DOG,Slané,37,37,0,37
"Mimosa 0,2l",Víno,36,36,0,29
Espresso tonic,Nealko,36,36,0,34
Bubliny - Glera,,36,36,0,27
příchuť,Nealko,35,35,0,33
VIP - Aperol Spritz,Ostatní alkohol,35,35,0,22
Basic,,35,35,0,34
Tortila hranolky sýr gyros,Slané,35,35,0,35
CHICKEN DOG,Slané,34,34,0,33
Flatwhite,Nealko,33,33,0,26
Bún bo nam bo,Slané,33,33,0,31
Náramek,Doplňkový sortiment,32,32,0,29
Espresso Tonic,Nealko,32,32,0,27
"Malfy Rosa 0,04l",Ostatní alkohol,30,30,0,20
Přímé zadání,Slané,29,29,0,29
Bún nem,Slané,28,28,0,28
Waffle navíc,Sladké,28,28,0,28
Pláštěnka koule,Doplňkový sortiment,27,27,0,25
Kečup / tatarka,Slané,27,27,0,26
"Stáčené víno 0,5 l",Víno,26,26,0,19
Stan,,26,26,0,0
Halloumi v žemli,Slané,25,25,0,24
Shisha half,,25,25,0,21
Mezizastávka,,25,25,0,17
3 dny/ osoba,,25,25,0,0
Voda,,25,25,0,23
Čaj,Nealko,24,24,0,16
Svítící náramky,Doplňkový sortiment,24,24,0,18
Waffle základ,Sladké,24,24,0,24
Svítící brýle,Doplňkový sortiment,24,24,0,24
1 den/ osoba,,22,22,0,0
Ledová káva,Nealko,22,22,0,21
alternativní mléko,Nealko,20,20,0,17
Triko,Doplňkový sortiment,19,19,0,19
čaj,Nealko,19,19,0,16
VIP -  Absolut Vodka + Juice,Ostatní alkohol,19,19,0,14
50 Kč,Doplňkový sortiment,19,19,0,19
VIP - redbull,Nealko,18,18,0,14
Hot dog CHILLI,Slané,18,18,0,18
Milkshake,Nealko,18,18,0,16
VIP - Ron de Azur,Ostatní alkohol,17,17,0,11
Klobouk,Doplňkový sortiment,16,16,0,15
VIP - Havana 3 Y.O.,Ostatní alkohol,16,16,0,12
Omáčka navíc,,16,16,0,16
Jack Daniel´s a Cola plech,,16,16,0,5
Triko Play collection,Doplňkový sortiment,14,14,0,13
"ICE-TEA 0,5l",,14,14,0,10
Placka,Doplňkový sortiment,14,14,0,14
VIP - Absolut vodka + redbull,Ostatní alkohol,13,13,0,10
VIP - Mimosa,Ostatní alkohol,12,12,0,9
Doner,,12,12,0,11
Čokoláda,Nealko,12,12,0,11
Sluneční brýle,Doplňkový sortiment,12,12,0,12
"Gentleman Jack 0,04l",Ostatní alkohol,12,11,1,8
Kuřecí v žemli,Slané,11,11,0,11
Křupačíno,Nealko,11,11,0,11
Havajský věnec,Doplňkový sortiment,11,11,0,11
Kamínky 1ks,Doplňkový sortiment,10,10,0,10
Sada kamínků,Doplňkový sortiment,10,10,0,10
Turek,Nealko,10,10,0,9
Nafukovací kytara,Doplňkový sortiment,10,10,0,10
"Jack Daniel's Single barrel 0,04l",Ostatní alkohol,9,8,1,4
Baseballová čepice,Doplňkový sortiment,9,9,0,9
Boxerské copánky ze 2 copů,Doplňkový sortiment,9,9,0,9
Masoňky kach.prsa 75g,Doplňkový sortiment,9,9,0,9
Latte,Nealko,9,9,0,8
"Láhvové víno 0,75 l",Víno,9,9,0,3
Trhané na salátu,Slané,9,9,0,9
Espresso Macchiatto,Nealko,8,8,0,8
Křuplatté,Nealko,8,8,0,8
Cokoliv,,8,8,0,8
Křupespresso,Nealko,7,7,0,7
Krabice velká,Doplňkový sortiment,7,7,0,7
Jack Daniel's + Soda,Ostatní alkohol,7,7,0,7
"Sluneční brýle 200,-",Doplňkový sortiment,7,7,0,7
přídavek,Nealko,7,7,0,7
Tetování malé,Doplňkový sortiment,6,6,0,4
"Prosecco 0,1l",,6,6,0,6
Kolag.kostičky 60g,Doplňkový sortiment,6,6,0,5
Mikina,Doplňkový sortiment,6,6,0,6
VIP - Jagermeister + cola,Ostatní alkohol,6,6,0,3
Kuřecí na salátu,Slané,6,6,0,6
Copánky,Doplňkový sortiment,5,5,0,4
Tetování,Doplňkový sortiment,5,5,0,5
Mlíko - Prazdroj,Pivo,5,5,0,4
Durum,,5,5,0,5
Multifunkční šátek,Doplňkový sortiment,5,5,0,4
Kolag.klobásky 3ks,Doplňkový sortiment,5,5,0,5
"Bellini 0,15l",Víno,5,5,0,5
Rasta copánek 1ks,Doplňkový sortiment,5,5,0,5
VIP - Beefeater dle nabídky,Ostatní alkohol,5,5,0,4
Espresso na ledu,Nealko,5,5,0,4
Ice Latté Macchiato,Nealko,5,5,0,5
Extra,Slané,4,4,0,3
Vysoký culík ze 2 copů,Doplňkový sortiment,4,4,0,4
Latte Macchiato,Nealko,4,4,0,4
Masoňky kuř.kousky 75g,Doplňkový sortiment,4,4,0,4
Churros přímé,,4,0,0,4
Chai Latte,Nealko,4,4,0,4
Shisha dark,,4,4,0,4
Pitíčko,Doplňkový sortiment,4,4,0,4
Espresso lungo,Nealko,4,4,0,4
Tetování střední,Doplňkový sortiment,3,3,0,3
Sladké,Sladké,3,3,0,2
Svítící brýle new,Doplňkový sortiment,3,3,0,3
Svítící náhrdelník,Doplňkový sortiment,3,3,0,3
Tlapičky 80g,Doplňkový sortiment,3,3,0,3
Hov.tyčinky 85g,Doplňkový sortiment,3,3,0,3
Vysoký culík z 6 copů,Doplňkový sortiment,3,3,0,3
Copánek z vlastních vlasů,Doplňkový sortiment,3,3,0,3
Capri sun,Nealko,3,3,0,3
Cappucino,Nealko,3,3,0,3
podsedák,Doplňkový sortiment,3,3,0,2
APA 12,Pivo,3,3,0,3
Flat White,Nealko,2,2,0,2
Vysoký culík ze 4 copů,Doplňkový sortiment,2,2,0,2
Křupčokoláda,Nealko,2,2,0,2
Copánek na gumičce/skřipeček 1 copánek,Doplňkový sortiment,2,2,0,2
Ledové Chai latte,Nealko,2,2,0,2
Chailatté,Nealko,2,2,0,2
Menu shisha light,,2,2,0,2
Polštářky kuř+sýr,Doplňkový sortiment,2,2,0,2
"Sluneční brýle 150,-",Doplňkový sortiment,2,2,0,1
brýle,Doplňkový sortiment,2,2,0,2
Mlsoňky 60g,Doplňkový sortiment,2,2,0,2
Žvýk.plátky 60g,Doplňkový sortiment,2,2,0,2
shot navíc,Nealko,2,2,0,2
Pletení bez kanekalonu - 10 minut,Doplňkový sortiment,2,2,0,2
Třpytky na 1 stranu,Doplňkový sortiment,2,2,0,2
Třpytky do pěšinky,Doplňkový sortiment,2,2,0,2
Kolag.tyčinky 75g,Doplňkový sortiment,2,2,0,2
Krabice malá,Doplňkový sortiment,2,2,0,2
Tetování velké,Doplňkový sortiment,2,2,0,2
Vídeň,Nealko,2,2,0,2
Double,,2,2,0,2
Polštářky antihairball,Doplňkový sortiment,2,2,0,2
Kostičky 80g,Doplňkový sortiment,1,1,0,1
Menu shisha half,,1,1,0,1
Chobotnička z 6 copů,Doplňkový sortiment,1,1,0,1
Tykadlo,Doplňkový sortiment,1,1,0,1
Taška,Doplňkový sortiment,1,1,0,1
Kytičková čelenka,Doplňkový sortiment,1,1,0,1
Vlnky,Doplňkový sortiment,1,1,0,1
Ručník,Doplňkový sortiment,1,1,0,1
Svítící čepice,Doplňkový sortiment,1,1,0,1
Pamlskovač,Doplňkový sortiment,1,1,0,1
Stehýnka 80g,Doplňkový sortiment,1,1,0,1
Třpytky na 2 strany,Doplňkový sortiment,1,1,0,1
Batoh Play collection,Doplňkový sortiment,1,1,0,1
šńůrka s karabinou,Doplňkový sortiment,1,1,0,1
Ponožky,Doplňkový sortiment,1,1,0,1
Klobásky 2ks,Doplňkový sortiment,1,1,0,1
